##########
#b  X   X#
#   g   C#
#   g    #
#  Cg%m t#
#   t  # #
#  C  p# #
#    PO# #
#  X   #E#
##########
