##########
#b  XC  X#
#   g    #
#     C  #
#   g%m t#
#   g  # #
#  Cp  # #
#    PO# #
#  X t #E#
##########
