##########
#b  X   X#
#P       #
#   C    #
#PP      #
#      # #
#  C   #C#
#  p  O# #
#  X   #E#
##########
